111111111111111111111
001111111111111111100
100000000000000000001
101110111111111011101
001110000000000011100
101110111111111011101
100000000000000000001
001111111101111111100
101000000000000000101
101011111111111110101
000011111111111110000
101011111111111110101
101000000000000000101
001111111101111111100
100000000000000000001
101110111111111011101
001110000000000011100
101110111111111011101
100000000000000000001
001111111111111111100
111111111111111111111