111111111111111111111
000000000000000000000
101010111111111010101
101010111111111010101
001000000000000000100
101101011111110101101
101101011111110101101
000001000000000100000
101101101010101101101
101101101010101101101
000001101000101100000
101101101010101101101
101101101010101101101
000001000000000100000
101101011111110101101
101101011111110101101
001000000000000000100
101010111111111010101
101010111111111010101
000000000000000000000
111111111111111111111

