111111111111111111111
000000000000000000000
101101110111011101101
100000000000000000001
001011111010111110100
101000000000000000101
101011011101110110101
001011010000010110100
101011010101010110101
101011010101010110101
000000000000000000000
101011010101010110101
101011010101010110101
001011010000010110100
101011011101110110101
101000000000000000101
001011111010111110100
100000000000000000001
101101110111011101101
000000000000000000000
111111111111111111111